No,1,2,3,4,5,6,7,8,9,10,10.1,11,12,13,14,15,16,17,Grade 
1,1,1,1,0,1,1,0,1,1,1,1,1,1,1,1,1,1,1,G1
2,1,1,1,1,1,0,1,1,0,1,0,0,1,1,1,1,0,1,G1
3,1,1,1,1,0,1,1,1,1,1,1,1,1,1,1,1,1,1,G1
4,1,1,1,1,1,1,1,1,0,1,1,1,0,0,1,1,1,0,G1
5,0,0,1,1,0,1,1,1,0,1,0,1,1,0,0,0,1,1,G1
6,0,1,0,0,0,1,0,1,0,0,0,1,0,1,1,1,0,1,G1
7,0,1,1,1,0,1,0,0,1,1,1,1,1,0,1,1,1,1,G1
8,1,1,1,1,1,1,1,1,1,1,1,1,1,1,1,1,0,1,G1
9,0,0,1,0,0,1,0,1,0,1,1,1,1,1,1,1,1,1,G1
10,0,1,0,1,0,1,0,1,1,1,1,1,1,1,1,1,1,1,G1
11,1,1,0,1,0,1,0,1,0,1,1,0,1,0,0,1,1,1,G1
12,1,1,1,1,1,1,1,1,1,1,1,1,0,0,1,0,1,1,G1
13,0,0,0,0,1,1,1,1,1,1,1,1,1,1,1,1,1,1,G1
14,0,1,0,1,0,1,1,1,1,1,1,1,1,0,1,1,1,1,G1
15,0,0,0,0,0,0,0,0,1,1,1,1,1,1,0,1,0,1,G1
16,1,0,0,1,1,0,0,1,0,0,0,0,1,0,0,0,0,0,G1
17,1,1,1,1,1,1,1,1,1,1,1,1,1,0,1,1,1,1,G1
18,1,1,1,1,1,1,1,1,1,1,0,1,0,1,1,1,1,1,G2
19,1,1,1,0,1,0,0,0,1,1,1,1,1,1,1,1,1,1,G2
20,1,1,1,1,1,1,1,1,1,0,0,1,0,0,1,0,1,0,G2
21,1,1,1,1,0,1,1,1,1,1,1,1,1,0,0,1,1,1,G2
22,1,1,1,1,1,1,1,0,1,0,0,1,0,0,0,0,1,0,G2
23,1,1,1,1,1,1,1,1,1,1,0,1,0,1,1,0,1,1,G2
24,1,1,0,0,1,0,1,0,1,1,1,1,1,0,1,1,1,1,G2
25,1,1,1,1,1,1,1,1,0,1,1,0,1,1,1,1,1,1,G2
26,0,1,1,1,1,0,1,1,1,1,1,1,1,1,0,1,1,1,G2
27,1,1,1,1,1,1,1,1,1,0,0,1,0,0,1,0,1,0,G2
28,1,0,1,0,1,0,1,0,0,0,0,0,0,0,1,0,0,0,G2
29,1,1,1,1,1,1,0,1,1,1,1,1,1,1,1,1,1,1,G2
30,1,1,1,1,1,1,1,0,1,0,0,1,1,1,1,1,1,1,G2
31,1,1,0,1,1,1,0,1,1,0,0,1,1,1,0,0,1,1,G2
32,0,1,1,1,1,1,1,1,0,1,1,1,1,1,1,1,1,1,G2
33,0,0,0,0,0,0,0,0,0,0,0,0,0,0,0,0,0,0,G2
34,0,0,0,0,0,0,0,0,0,0,0,0,0,0,0,0,0,0,G2
35,1,1,1,1,1,1,1,1,0,0,0,0,0,0,0,0,0,0,G2
36,0,0,1,0,1,0,1,0,1,0,0,1,0,0,1,0,0,0,G2
37,0,1,1,0,1,1,1,1,1,0,0,0,1,0,1,1,1,1,G2
38,0,0,0,0,0,0,0,0,0,0,0,1,0,1,0,1,0,0,G2
39,1,1,1,1,1,1,1,1,1,1,1,1,1,0,0,0,1,1,G3
40,1,0,0,0,0,0,0,0,0,0,0,0,0,0,0,0,0,0,G3
41,0,0,0,0,0,0,0,0,0,0,0,0,0,0,0,0,0,0,G3
42,1,1,1,1,1,1,1,1,1,0,0,1,1,0,1,0,1,0,G3
43,1,1,1,1,0,1,1,1,1,0,0,1,0,0,1,0,0,0,G3
44,0,0,0,0,0,0,0,0,0,0,0,0,0,0,0,0,0,0,G3
45,0,0,0,0,0,0,0,0,0,0,0,0,0,0,0,0,0,0,G3
46,0,1,0,1,1,1,1,1,1,1,1,1,1,0,1,1,0,1,G3
47,0,0,0,0,0,0,0,0,1,0,0,0,0,0,0,0,0,0,G3
48,1,1,1,1,1,1,1,1,0,1,0,0,1,0,1,1,1,1,G3
49,0,0,0,0,0,0,0,0,0,0,0,0,0,0,0,0,0,0,G3
50,0,0,1,0,0,0,0,1,1,1,1,1,1,1,1,1,1,1,G3
51,1,1,1,1,1,1,1,1,1,1,1,1,1,1,1,1,1,1,G3
52,0,1,0,1,0,0,0,0,0,0,0,0,0,0,0,0,0,0,G3
53,1,0,0,1,0,1,0,1,1,1,1,1,1,1,1,1,1,1,G3
54,1,1,1,0,1,1,1,1,1,0,0,0,0,0,0,0,1,0,G3
55,1,1,1,1,1,1,1,1,1,1,1,0,1,0,1,1,1,1,G3
56,0,1,1,1,1,0,1,1,1,1,1,1,0,1,1,1,1,1,G3
57,1,0,0,0,0,1,0,0,0,0,0,0,0,0,1,0,1,0,G3
58,0,0,0,0,0,0,0,0,0,0,0,0,0,0,0,0,0,0,G3
59,0,0,0,0,0,0,0,0,0,0,0,0,1,1,0,0,0,0,G3
60,0,0,0,0,0,1,0,0,1,1,0,0,1,1,1,1,1,1,G3
61,0,0,1,1,0,1,1,1,1,0,0,1,0,0,1,1,1,1,G3
62,0,0,0,0,0,0,0,0,1,1,1,0,1,1,0,1,1,1,G3
63,1,1,0,1,1,1,1,1,1,1,1,1,1,0,1,1,1,1,G3
64,1,0,0,0,1,0,1,0,0,0,0,0,0,0,0,0,0,0,G3
65,0,0,1,0,1,1,0,1,1,1,1,1,1,0,0,1,1,1,G3
66,1,1,0,0,1,1,1,0,1,1,1,0,1,0,1,1,0,1,G3
67,1,1,1,1,0,1,1,1,1,1,1,0,1,1,1,1,1,1,G3
68,0,0,0,0,1,0,0,0,0,0,0,0,0,0,0,0,0,0,G3
69,1,1,0,0,0,1,1,1,1,1,1,1,0,1,1,1,1,1,G3
70,0,0,1,0,0,0,0,0,0,0,0,1,0,0,1,0,1,0,G3
71,1,1,1,1,1,1,1,1,1,1,1,1,1,1,1,1,1,1,G3
72,1,0,1,1,1,1,1,1,1,1,0,0,0,1,1,0,1,0,G3
73,1,1,1,1,1,1,1,1,1,1,1,0,1,0,1,1,0,0,G3
74,1,1,0,1,1,1,1,1,1,1,1,1,1,1,1,1,1,1,G3
75,0,1,0,0,0,1,0,0,1,1,1,1,1,1,0,1,1,1,G3
76,1,1,1,1,1,1,1,1,0,1,1,0,0,0,1,1,0,0,G3
77,1,1,1,1,0,1,1,1,1,1,1,1,1,1,1,1,1,1,G3
78,1,1,1,0,1,1,1,0,1,0,0,1,0,0,1,0,1,0,G3
79,0,0,0,0,0,1,1,1,0,1,0,0,0,0,0,1,1,0,G3
80,0,0,0,0,0,0,0,0,0,0,0,0,0,0,0,0,0,0,G3
81,1,1,1,1,1,1,1,1,0,0,0,0,0,0,0,0,0,0,G3
82,1,1,1,1,1,0,1,0,1,0,0,0,0,0,1,0,1,1,G3
83,1,1,1,1,1,1,1,1,1,0,0,1,1,0,1,0,1,1,G4
84,0,0,1,1,0,1,0,1,1,1,1,1,1,0,1,1,1,1,G4
85,1,1,1,1,0,1,0,1,1,1,1,1,1,0,1,1,1,0,G4
86,1,1,0,1,1,1,0,1,1,1,1,1,1,0,1,1,1,1,G4
87,0,1,0,1,1,1,0,1,1,1,0,0,0,1,1,1,1,1,G4
88,1,0,1,0,1,0,1,1,1,1,1,1,0,0,1,0,1,1,G4
89,0,1,1,1,1,1,0,1,1,0,0,1,1,1,1,1,0,1,G4
90,1,1,1,1,1,1,1,1,0,1,1,1,1,1,0,0,1,1,G4
91,0,0,0,0,0,0,0,0,0,0,0,0,1,1,0,1,1,1,Normal
92,0,0,0,0,0,1,1,1,1,1,1,1,1,1,1,1,1,1,Normal
93,0,1,0,1,1,1,1,1,1,1,1,1,1,1,0,1,0,1,Normal
94,1,1,0,0,1,1,1,0,0,0,0,0,0,0,0,0,0,0,Normal
95,1,1,1,1,1,1,1,1,1,1,1,0,1,1,0,0,1,0,Normal
96,1,1,1,1,1,1,1,1,1,1,0,1,1,1,1,1,1,1,Normal
97,0,0,0,0,0,1,0,1,1,1,1,1,1,1,1,1,1,1,Normal
98,1,1,1,1,0,0,0,1,0,1,1,0,0,0,1,1,1,0,Normal
99,1,1,1,1,1,1,1,0,1,1,1,1,1,1,1,1,1,1,Normal
100,1,1,1,1,0,1,1,1,1,1,1,1,1,1,1,1,1,1,Normal
101,1,1,1,1,1,1,1,1,1,0,0,1,1,1,1,1,0,1,Normal
102,1,1,0,1,1,1,1,1,1,0,0,1,1,0,1,1,1,1,Normal
103,1,1,1,1,0,0,0,1,1,1,0,0,1,1,0,1,1,1,Normal
104,0,1,1,1,1,1,1,1,1,1,1,1,1,1,1,1,1,1,Normal
105,1,1,1,1,1,1,1,1,1,1,0,1,1,0,0,1,0,1,Normal
106,0,1,0,1,0,0,0,0,0,0,0,0,0,1,0,1,0,0,Normal
107,1,0,1,1,1,0,1,1,1,1,1,1,0,0,1,0,1,1,Normal
108,0,1,0,0,1,1,0,1,1,1,1,0,1,1,1,1,1,1,Normal
109,0,0,0,1,0,0,0,1,1,1,1,1,1,1,1,1,1,1,Normal
110,0,1,0,0,0,0,0,0,1,1,1,1,1,1,1,1,1,1,Normal
111,0,1,0,1,1,1,1,1,1,1,0,1,0,1,1,1,1,1,Normal
112,1,1,1,1,0,1,1,1,0,1,0,1,1,1,1,0,1,1,Normal
113,1,1,1,0,1,1,1,1,1,0,0,1,0,1,1,0,1,0,Normal
114,1,0,1,1,0,1,0,1,1,1,1,1,1,1,1,1,1,1,Normal
115,0,0,0,0,0,0,0,0,0,1,0,0,0,1,0,0,0,0,Normal
116,0,0,0,0,0,0,0,0,0,1,1,1,1,1,1,1,1,1,Normal
117,0,0,0,0,1,1,0,0,1,1,1,1,1,1,0,1,1,1,Normal
118,0,0,0,1,1,0,1,1,1,1,1,0,1,1,1,1,1,1,Normal
119,0,1,1,1,0,0,0,1,1,1,0,0,1,1,1,1,1,1,Normal
120,1,1,1,0,1,1,0,1,1,1,1,0,1,1,1,1,1,1,Normal
121,1,1,1,1,1,1,1,1,0,0,0,0,0,0,1,0,0,0,Normal
122,1,1,1,1,1,1,1,1,1,1,1,1,1,1,1,0,1,1,Normal
123,1,1,1,1,1,1,1,1,1,1,0,1,0,1,1,1,1,1,Normal
124,1,1,1,1,1,1,1,1,1,0,0,1,1,1,1,1,1,1,Normal
125,0,1,1,1,0,1,0,1,1,1,1,1,1,1,1,1,1,1,Normal
126,1,1,1,1,1,1,1,1,1,1,1,1,1,0,1,1,1,1,Normal
127,0,1,1,1,0,1,1,1,0,0,0,1,1,0,1,0,1,1,Normal
128,1,1,1,1,1,0,1,1,1,1,0,1,0,0,1,1,1,1,Normal
